000000000000
000000000000
000000000000
000000011111
000011111111
000011111111
000111111111
000011111112
000000111122
000000002222
222222222222
222222222222